wwwwwwwwwwwwwwwwwwwwwwwww
w.....O.................w
w.....O.................w
w..OOOOOOOOOOOOOOOO.....w
w..OOOOOOOOOOOOOOOO.....w
w.......................w
w.......................w
w.......................w
w.......................w
w...........P...........w
w.......................w
wwwwwwwwwwwwwwwwwwwwwwwww