wwwwwwwwwwwwwwwwwwwwwwww
w....................c.w
w......................w
w......................w
w.......c..............w
w......................w
w......................w
w........c.............w
w......................w
w.P....................w
w......................w
wwwwwwwwwwwwwwwwwwwwwwww