wwwwwwwwwwwwwwwwwwwwwwwww
wrrrrrrr................w
wrrrrrrrr...............w
w....rrrr...............w
w.......................w
w.................O.....w
w.......................w
w.........ccccc.........w
w.........c...c.........w
w.........c.P.c.........w
w.........c...c.........w
wwwwwwwwwwwwwwwwwwwwwwwww