wwwwwwwwwwwwwwwwwwwwwww
w....r.....l..........w
w.....................w
w..M.......B..........w
w......rr........M....w
w.....r...............w
w...r............rrr..w
w...r...........r.....w
w............r........w
w..........r..........w
w.M..............M....w
w.....................w
w.rrrr...........rrrr.w
w..M..................w
w................rrr..w
w................rr...w
w..........P..........w
wwwwwwwwwwwwwwwwwwwwwww