wwWwwWwddwWwwWww
w..............w
w......M.......w
w..rr.rrrr.rr..w
w......rr......w
w...c.s.hs.....w
w.....s..s.c...w
w......rr......w
w..rr.rrrr.rr..w
w..............w
w......P.......w
wwwwwwwwwwwwwwww