wwwwwwwddwwwwwww
w....r....r....w
w....r....r....w
wrrrrr....r....w
w...ss....r....w
wh..ss....r....w
w...ss....r....w
wrrrrr....r....w
w....rssssr....w
w....rs..sr....w
w....rsP.sr....w
wwwwwwwwwwwwwwww