wwwwwwwddwwwwwww
wHr..........rhw
wsr..........rsw
w..............w
w......cc......w
ws............sw
w.s..........s.w
w..s........s..w
w...s......s...w
w.C..s....s..C.w
w....rsP.sr....w
wwwwwwwwwwwwwwww