wwwwwwwddwwwwwww
wrr..r.......rrw
wr......s....Hrw
w..M....r....M.w
w...s..r...s.r.w
w..............w
w.r.s..........w
w..............w
w..M.....r...M.w
wrh...........rw
wrr....P.....rrw
wwwwwwwwwwwwwwww