wwwwwwwddwwwwwww
w..............w
w.M..........M.w
ww............ww
wwwwwwwsswwwwwww
wwc.s.s..s.s.cww
wwc.s.s..s.s.cww
wwwwwwwsswwwwwww
ww............ww
w..............w
w......P.......w
wwwwwwwwwwwwwwww