wwwwwwwddwwwwwww
w.r............w
w..M.......r...w
w....s.........w
w......r...M...w
w....M.........w
w....r......r..w
w......s.r.....w
w..M...........w
w...rrrrrrrr...w
w...r....r.....w
w......s.......w
w...r.......r..w
w.....r........w
w..............w
w......P.......w
wwwwwwwwwwwwwwww