wwwwwwwwwwwwwwwwwwwwwww
w....r.....L..........w
w.....................w
w..M.......B.....M....w
w......rr.............w
w.....r...............w
w...r......r......rrr.w
w...r...........r.....w
w............r........w
w........r..r.........w
w.....................w
w.....................w
w.rrrr...........rrrr.w
w........rrrrr........w
w..............rrrrr..w
w................rr...w
w..........P..........w
wwwwwwwwwwwwwwwwwwwwwww