wwwwwwwddwwwwwww
w..............w
w..............w
w..............w
w..............w
w..b..b..b..b..w
w..............w
w..............w
w..............w
w..............w
w......P.......w
wwwwwwwwwwwwwwww