wwwwwwwwwddwwwwwwww
wrrrr.............w
wrrc.M..........M.w
w.........hH......w
w.................w
w........rr.......w
w.................w
w.M...............w
wrr..............rw
wrrr...........Mrrw
wrrrrrrr.P.....rrrw
wwwwwwwwwwwwwwwwwww