wwwwwwwwwddwwwwwwww
wccM..............w
wccM.r......r.....w
wrrr...........M..w
w....r...r...r....w
w........rr.......w
w......r.Crr.r....w
wr...........r....w
wr.......r........w
wrrr............rrw
wrrr.....P....rrrrw
wwwwwwwwwwwwwwwwwww