wwwwwwwwwwwwwwwwwwwwww
w..........l.........w
w....................w
w..........B.........w
w....................w
w....................w
w....................w
w....................w
w....................w
w....................w
w....................w
w....................w
w....................w
w...rrrrr....rrrrr...w
w....................w
w....................w
w.........P..........w
wwwwwwwwwwwwwwwwwwwwww