wwwwwwwddwwwwwww
w.....r..r.....w
w.....r..r.....w
w.rrr.r..rrrrrrw
wr.h.rr........w
wr.C.rr........w
wr...rrrrrrrr..w
w...........r..w
w...M.......r..w
w.M.........r..w
wrrrrrr..r..r..w
w.....r..r..r..w
w.....r..r..r..w
w.....r..r..r..w
w.....r..r.....w
w.....rP.r.....w
wwwwwwwwwwwwwwww