wwwwwwwddwwwwwww
w...........scsw
w...........scsw
w..ssssssssssssw
w..s...........w
w..s...........w
w..s.rsssssss..w
w..s..s.....s.rw
w..s..s.....s..w
w.....s..s.....w
wr....sP.s.....w
wwwwwwwwwwwwwwww