wwwwwwWddWwwwwww
w..............w
w..............w
w.....srrs.....w
w..............w
w..............w
w..rrrsccsrrr..w
w....rscHsr....w
w....rsMMsr....w
w.....rrrr.....w
w..............w
w..............w
w.....r..r.....w
w.....r..r.....w
w.....r..r.....w
wc....rP.r....cw
wwwwwwwwwwwwwwww