wwwwwwWddWwwwwww
w.......M......w
w.M..........M.w
wtttttt..ttttttw
w..r........r..w
w..............w
ws............sw
wstttt.ttHttttsw
ws...r....r.r.sw
w..............w
w......P.......w
wwwwwwwwwwwwwwww